111111111
100000011
1C00E0001
111111111