111111111
1000000P1
1C00E00011
111111111