111111111
10000P0H1
1C00E0001
111111111