111111111
1000000P1
1C00E0001
111111101