111111111
1000000P1
1C00E0000
111111111