11111111111111111111111
1P00011100000000000C001
100000000111C0000000001
1000000000111111000C001
100C0000111111000001101
100000000C00000E0000001
11111111111111111111111
