11111111111111111111111111111111111111111111111111111111
111100000000000000000000000000000000100000000S0000000001
1110C000000000000000000000000000000110000000000000000001
10000000000000000000000000000000000000001000000000000001
11000000000000000C0000000000000000000C000000000000000001
1111000S0000000000000000000110000000000000000000000C0001
111100000000000C0000000111111110000000000010000000000001
11000000000000000000111111110000000000001000000000000111
10000C00000000000000000000011110000000001000000000011111
100000000000000000000000000000C00000000010000000S0000011
10000000000000000000000000000000000000000000000000000001
1000000000011111100000000000000010111000000C000000000001
1000000P0000001110C0000000000000111111110000000000001111
11S00000000000000000000000000000111111100000000000000001
11110000000000000000000000000011111100000000000000000001
11100000000C0000000000000S00000011111000S000000000000001
1100000000000001111111000000000011110000000000000000E001
110000000000000110C000000000000011100000000000C000000001
11111111111111111111111111111111111111111111111111111111