111111
1C00E1
100P01
1S0001
111111