11111111111111111111111
1P000000S00000000000001
10000000000000000000001
1000000000000000000C001
100C0000000000000000001
10000000000000000000001
100000000000000000S0001
10000C00000000000000001
1000000000E000000000001
100000S000000000000C001
11111111111111111111111